NO ./xpm/N.xpm
SO ./xpm/S.xpm
WE ./xpm/W.xpm
EA ./xpm/E.xpm

F 120,111,100   
C 225,225,225                


    111111111111111111111111
    100000000000000000000001
    100000000000000000000001
    100000000000000000000001
    10000000000N000000000001 
    100000000000000000000001
    100000000000000000000001
    111111111111111111111111