NO ./xpm/N.xpm
SO ./xpm/S.xpm
WE ./xpm/W.xpm
EA ./xpm/E.xpm

F 12,11,1   
C 0,0,0                


         111111111111111111111
    1111111000000000000111111111
    11111000000N00000000100111
      11110000000000000011111
        11111111111111111